....XX....
....X.....
..........
..........
...XXX....
..........
..........
..........
....X.....
..........